EMOJI	EMOJI NAME	MEANING	OTHER NAMES
ğŸ˜€	Grinning	It conveys cheerfulness and extreme happiness towards something	Grinning face
ğŸ˜ƒ	Smiley	The Smiley emoji denotes happiness and positive feelings	Grinning face with big eyes
ğŸ˜„	Smile	The smile emoji depicts a personâ€™s happiness when sending a greeting text or simply used to compliment something or the other 	Grinning face with smiling eyes, happy face, smiley face
ğŸ˜	Grin	The grin emoji represents mischievousness but can be used to give away excitement and enjoyment	Beaming face with smiley eyes, cheesy face
ğŸ˜†	Laughing	The emoji depicts laughter often used to react to something hilarious	Grinning squinting face emoji
ğŸ˜…	Sweat smile	Used to depict a close call but is also often used in awkward situations during a chat	Phew emoji, grinning face with sweat, relief emoji
ğŸ¤£	Rolling on the floor laughing	Used when one canâ€™t stop their laughter over something	Titled laughter
ğŸ˜‚	Joy	When one sheds tears of joy over something	Face with tears of joy, haha emoji
ğŸ™‚	Slightly smiling face	An emoji that can have two or more meanings to it such as being positive, happy or patronizing and being ironic	Ironic smile, pain behind the smile
ğŸ™ƒ	Upside down face	The emoji depicts being silly and sarcastic	Sarcasm, silly
ğŸ˜‰	Wink	This emoji signals an inside joke or a hidden meaning that when used wonâ€™t be understood by others	Winky face
ğŸ˜Š	Blush	This emoji expresses extreme happiness and positive feelings	Happy, blush face
ğŸ˜‡	Innocent	This emoji means being as innocent and pure as an angel, being unaware of something	Angel
ğŸ˜	Heart eyes	Taken straight from cartoons, the hearted eyes emoji is used to convey feelings of love and attraction towards something/someone	Heart face
ğŸ˜˜	Kissing heart	The emoji is used to convey goodbye to loved ones	Blowing kiss
ğŸ˜š	Kissing closed eyes	The pink cheeks and puckered lips on this emoji convey sentiments of love and affection	Kissy, kiss
ğŸ˜™	Kissing smiling eyes	This emoji is also used to convey sentiments of love and affection but in a light-hearted way	Kissy
ğŸ˜‹	Yum	Used to express oneâ€™s reaction towards a delicious meal, or mouth watering at the sight of the meal	Tasty, delicious
ğŸ˜›	Stuck out tongue	This conveys a sense of excitement, fun, mischievousness, and cuteness	Tounge out
ğŸ˜œ	Stuck out tongue winking eye	Used when just casually kidding around with jokes and funny conversations	Crazy
ğŸ˜ï¸	Neutral face	When the other person doesnâ€™t get the joke but can also be used in context to concern for someone	Straight face emoji
ğŸ˜‘	Expressionless	The flat eyes and mouth convey a sense of frustration or disappointment	Straight mouth
ğŸ¤”	Thinking face	Depicts going into a deep state of thinking	Thinker
ğŸ¤«	Shushing face	When the chat has gone with loads of messages and you want to make everyone quiet	Shh, quiet emoji, hush
ğŸ¤—	Hugging face	This emoji depicts a sense of affection for someone	Hugging, Aww come here!
ğŸ¤	Zipper mouth face	Used when secrets and promises are to be kept among an only a certain number of people	Lips sealed, zit it
ğŸ¤‘	Money mouth face	This emoji conveys the feeling of getting a good sum of money	Dollar sign eyes, money face
ğŸ˜¶	No mouth	This conveys the situations when one has no words to speak due to being disappointed in a positive or negative way	Blank face, mouthless, silence
ğŸ˜	Smirk	The emoji to use when youâ€™ve achieved something great and canâ€™t wait to boast about it	Flirting face, smug face, suggestive face
ğŸ˜’	Unamused face	Generally related to negative emotions. This emoji conveys grumpiness or irritation towards someone or something	Dissatisfied, Meh, Unimpressed
ğŸ™„	Face with rolling eyes	Used when the other person says something obvious or too dumb	Eye roll
ğŸ˜¬	Grimacing face	The wide-open mouth and clenched teeth depict awkwardness or nervousness	Awkward, eek, nervous
ğŸ¤¥	Lying face	taken straight from the fictional character Pinocchio, this emoji depicts lying	Liar, long nose, Pinocchio
ğŸ˜Œ	Relieved face	This emoji depicts a sense of calmness, peace, or satisfaction	Content, pleased
ğŸ˜”	Pensive face	An emoji used to describe a state of pain and sorrow	Sad, sad face, sorrowful
ğŸ˜´	Sleeping face	One can use this emoji to convey â€œgood nightâ€ to a chat	Sleepy, Zzz face
ğŸ˜ª	Sleepy face	The emoji depicts the feeling of exhaustion after a long tiring day	Side-tear, snot bubble
ğŸ¤¤	Drooling face	This emoji denotes the irresistibility over a yummy food	Drool, water-dropping
ğŸ˜·	Face with medical mask	This describes the wearing of a mask to protect from viruses and airborne diseases	Coronavirus, COVID-19, face mask
ğŸ¤’	Face with thermometer	This emoji depicts a sick person	Sick, ill
ğŸ¤•	Face with head bandage	The emoji denotes a bad head injury	Clumsy, bandaged head, injured
ğŸ¤¢	Nauseated Face	The face depicts â€˜about to throw upâ€™.	Disgusting, vomit face, yuck!
ğŸ¤®	Face vomiting	This represents disgust or an actual food illness	Spew, throwing up, vomit
ğŸ¤§	Sneezing face	The emoji to use when someone has fallen sick and caught cold	Gesundheit, sneeze
ğŸ¥µ	Hot face	When the temperature is rising	Overheated face, so damn hot!
ğŸ¥¶	Cold face	When temperature touches rock bottom. Extremely cold	Freezing face, Coldness, do damn cold!
ğŸ¥´	Woozy face	When you had too much booze	Drunk face
ğŸ˜µ	Face with crossed-out eyes	This emoji denotes disbelief or in some cases even death	Dizzy face
ğŸ¤¯	Exploding head	Read, heard, or saw something extremely shocking and amusing	Mind blow, what theâ€¦
ğŸ¤ 	Cowboy hat face	A simple smiley emoji with a cowboy hat	Cowboy, brown hat face
ğŸ¥³	Partying face	Party time!	Letâ€™s party!
ğŸ¥¸	Disguised face	Sneaking into solving a particular case or matter	Detective
ğŸ˜	Smiling face with sunglasses	Feeling overachieved and cool	Sunglasses, cool, Oh yeah!
ğŸ¤“	Nerd face	Depicting a mind loaded with theoretical knowledge	Class topper, Nerdy
ğŸ§	Face with Monocle	This emoji depicts taking a closer into something	Detective mode ON, something fishy
ğŸ˜•	Confused face	An emoji giving a look of uncertainty	Puzzled, nonplussed
â˜¹ï¸	Frowning face	This emoji denotes a deeply saddened state	Megafrown, disappointment
ğŸ˜®	Face with Open mouth	A round mouth emoji describes a shock that makes one go â€˜wow!â€™	Open mouth, surprised
ğŸ˜¯	Hushed face	The emoji depicts mild amusement or surprise	Surprised face, surprise
ğŸ˜²	Astonished face	Used when one comes across something amusing or shocking in both positive or negative way	Drunk face, gasping face
ğŸ˜³	Flushed face	A surprised emoji with eyes wide opened	Embarrassed, blushing face, shame
ğŸ¥º	Pleading face	Depicts wanting of something so bad that their eyes become full of tears	Begging, glossy eyes, simp
ğŸ˜§	Anguished face	Depicting sadness and disappointment at the same time	Pained face
ğŸ˜¨	Fearful face	This emoji intends to depict fear from someone or something	Scared, surprised
ğŸ˜¥	Sad but relieved face	Sad and relieved at the same time as things couldâ€™ve gone much worst	Eyebrow sweat
ğŸ˜­	Loudly crying face	This emoji conveys inconsolable grief but is also used in fun ways such as laughter or over-the-top joy	Sobbing, sad tears, crying out loud
ğŸ˜±	Face screaming in fear	This emoji depicts a high degree of shock which can be both positive and negative	Home alone, scream, shocked
ğŸ˜–	Confounded face	The zig-zag mouth with crossed eyes on this emoji conveys irritation, sadness, and rather all kinds of negative feelings	Quivering face, scrunched face
ğŸ˜	Disappointed face	This emoji conveys an unhappy and sad face due to some recent events	Sad, sad face
ğŸ˜“	Downcast face with sweat	This emoji conveys a certain degree of sadness, pain, or disappointment	Hard work, dejected
ğŸ˜«	Tired face	When youâ€™ve had a rough and tiring day at work	Exhausted, fed up
ğŸ¥±	Yawning face	Used when someoneâ€™s feeling sleepy	Feeling sleepy
ğŸ˜¤	Face with steam from nose	Taken inspiration from manga or anime, this emoji depicts angriness and frustration	Triumph, steaming, frustrated
ğŸ¤¬	Face with symbols on the mouth	This emoji depicts vulgar behavior due to being too much furious at someone or something	Cursing, swearing
ğŸ‘¿	Angry face with horns	When the sender of this emoji becomes so angry that they turn into devils with horns	Devil, devil horns, ultra angry
ğŸ˜ˆ	Smiling face with horns	When the sender of this emoji is onto something mischievous or wicked	Happy devil
ğŸ’€	Skull	This emoji represents death from extreme laughter or frustration	Death, death skull
ğŸ’©	Pile of poo	One of the most popular emojis. a poo emoji can be used to describe something as silly or funny but in a disgusting way	Smiling poop, dog dirt
ğŸ¤¡	Clown face	A circus clown can be used to describe something as creepy or haunted	Joker, what a joke!
ğŸ‘¹	Japanese ogre	A kind of hideous ogre in Japanese folklore	Mask face, Oni, red monster
ğŸ‘º	Goblin	The goblin emoji denotes evil, anger, cruel behavior	Long face mask, red mask, grumpy monster
ğŸ‘»	Ghost	The ghost emoji can be used to convey someone or something as goofy and strange	Halloween, disappear, Snapchat
ğŸ‘½	Alien	A spooky face of an alien from outer space	Outer space creature
ğŸ‘¾	Alien monster	An alien monster from a video game of some sort	Space invader, video game monster
ğŸ¤–	Robot face	The head of a classic vintage robot	Droid, robot
ğŸ±	Cat face	A yellow cat face emoji	Smiley cat, kitty, smiling cat
ğŸ™ˆ	See no evil monkey	A monkey covering its eyes	Monkey covering eyes
ğŸ™‰	Hear no evil monkey	A monkey covering its ears 	Monkey covering eyes
ğŸ™Š	Speak no evil monkey	A monkey covering its  mouth 	Monkey covering mouth
ğŸ‘¦	Boy face	A simple emoji portraying a boyâ€™s face	Boy, child boy
ğŸ‘§	Girl face	A simple emoji portraying a girlâ€™s face	Girl, child girl
ğŸ‘€	Eyes	Huge eyes emoji with the pupil pointing to the left	Eyeballs, wide-open eyes, what happened!?
âœï¸	Writing hands	An emoji depicting the action of writing with a pen or pencil	Writing, write
ğŸ‘‹	Waving hand	Used either at the start or at the end of the conversation	Goodbye, hello, hand wave
ğŸ¦¾	Mechanical arm	A robotic artificial arm	The robotic arm, metal arm, artificial arm
ğŸ¤³	Selfie	A human arm depicting the action of taking a selfie from a mobile phone	Selfie hand, hand cam
ğŸµ	Monkeyface	A monkeyface emoji with wide-open eyes	Monkey head
ğŸ’	Monkey	A small primate with long limbs	Cheeky monkey
ğŸ¦	Gorilla	An emoji of a grey-haired gorilla	â€“
ğŸ¦§	Orangutan	The orange-haired ape emoji with long arms	â€“
ğŸ¶	Dogface	An emoji portraying the face of a dog	Puppy, doggy
ğŸ•	Dog	A dog emoji generally known as â€˜humanâ€™s best friend	Doggo
ğŸº	Wolf	An emoji portraying the face of a wolf	Wolf face
ğŸ¦Š	Fox	An emoji portraying the face of a fox	Fox face
ğŸ¦	Raccoon	A gray raccoon emoji	â€“
ğŸˆ	Cat	A cat emoji which is generally kept as a pet	Feline, house cat
ğŸ¦	Lion face	A simple emoji with a face of a lion	Lion
ğŸ…	Tiger	A large orange cat with black stripes across its body	Bengal tiger
ğŸ†	Leopard	A large yellow cat with black yellow spots	Jaguar
ğŸ	Horse	A horse emoji is depicted as galloping toward the left	Racehorse, galloping horse
ğŸ¦„	Unicorn	A mythical and fantasy animal	â€“
ğŸ¦“	Zebra	An emoji of the popular black striped animal called zebra	â€“
ğŸ¦¬	Bison	A brown bison showed in full profile with horns, a beard, and a woolly mane	Buffalo
ğŸ„	Cow	A dairy cow emoji with black spots on its body	Dairy cow
ğŸ‚	Ox	An emoji depicting a brown ox	Oxen, bull
ğŸª	Camel	An emoji portrayal of a desert animal	Desert camel, Arabian camel
ğŸ¦™	Llama	A rare camel-like animal found in South America	Alpaca
ğŸ¦’	Giraffe	A face emoji of the tallest animals around called a giraffe	â€“
ğŸ˜	Elephant	An emoji of the largest animal on the planet known as the elephant	â€“
ğŸ¦	Rhino	A large mammal with massive horns	Rhinoceros
ğŸ¦£	Mammoth	A wooly extinct creature with long curvy tasks	â€“
ğŸ¦›	Hippo	An emoji of a huge water mammal with big jaws	Hippopotamus
ğŸ	Mouse	A bright mouse emoji with a long pink tail	Rodent, mice
ğŸ€	Rat	A rat emoji with a long pink tail	Rodent
ğŸ¹	Hamster	A small cute rodent often kept as a pet	Hamster face
ğŸ‡	Rabbit	A mammal that loves to eat and has long eats	Bunny
ğŸ¿ï¸	Squirrel	A rodent with big and puffy cheeks 	Chipmunk
ğŸ¦”	Hedgehog	An emoji of a small spiny mammal called hedgehog	Spike
ğŸ¦‡	Bat	A bat emoji that can also be used to describe the superhero Batman	Batman
ğŸ»	Bear	An emoji portrayal of a panda	Teddy bear
ğŸ»â€â„ï¸	Polar bear	An emoji of an animal found in arctic places	Bear face
ğŸ¼	Panda	An emoji depicting a panda	Panda face
ğŸ¦˜	Kangaroo	An emoji of a kangaroo	Roo
ğŸ•Šï¸	Dove	A bird associated with the symbol of peace	Dove of peace
ğŸ¦…	Eagle	An emoji portrayal of the majestic bird eagle	Bald eagle
ğŸ¦‰	Owl	An emoji of a large-eyed bird owl	â€“
ğŸŒ²	Evergreen tree	An evergreen tree is one that keeps its leaves all year long	Fir tree, Pine tree
ğŸŒµ	Cactus	A cactus plant emoji	Desert
ğŸŒ´	Palm tree	A tree on which coconuts grow	Coconut tree
ğŸŒ¿	Herb	A green herb emoji	Crop
ğŸ	Maple leaf	An orange maple leaf is also associated with the country Canada	Canada
ğŸŒ¹	Rose	A vibrant red rose emoji with the stem. Often used as a symbol of love	Red rose, red flower
ğŸ‡	Grapes	A grape bunch emoji	Grape
ğŸˆ	Melon	A light green melon emoji	Cantaloupe, Honeydew
ğŸ‰	Watermelon	A slice of watermelon showing the juicy red part with black seeds	â€“
ğŸŠ	Orange	An emoji portraying the pulpy fruit known as orange	Tangerine, Mandarin
ğŸ‹	Lemon	The yellow and sour citrus fruit called lemon	Lemonade
ğŸŒ	Banana	A peeled banana emoji	Monkey snack
ğŸ	Pineapple	The tropical fruit pineapple with a shoot of leaves at the top	â€“
ğŸ¥­	Mango	An emoji of a tropical mango	Mangifera
ğŸ	Apple	A vibrant red apple emoji	Red apple
ğŸ	Green apple	An emoji portraying a green apple	Granny apple
ğŸ	Pear	An emoji portraying a green pear	â€“
ğŸ‘	Peach	An emoji portraying a peach	Bottom
ğŸ“	Strawberry	A red fruit called strawberry topped with green leaves	â€“
ğŸ’	Cherries	Two cherries with a leaf	Cherry
ğŸ¥	Kiwi	A kiwi fruit sliced open to show the actual fruit along with black seeds	Chinese gooseberry
ğŸ…	Tomato	A full red tomato with green stem	Tomato plant
ğŸ¥¥	Coconut	A half-cut coconut emoji showing its white meat	â€“
ğŸ¥‘	Avocado	A half-cut avocado emoji exposing the brown pit in the middle	â€“
ğŸ†	Eggplant	An eggplant emoji with a green stem	Brinjal
ğŸ¥”	Potato	A potato emoji	Baked potato
ğŸ¥•	Carrot	A long bright orange carrot emoji with green leaves on the top	â€“
ğŸŒ½	Corn	An ear of golden corn partially husked	Ear of corn, maize
ğŸŒ¶ï¸	Hot pepper	A bright red chili	Chilli, spicy
ğŸ¥¦	Broccoli	An emoji depicting broccoli	Green veggie
ğŸ	Bread	A loaf of bread	Loaf of bread
ğŸ¥“	Bacon	An emoji depicting bacon	Bashers
ğŸ”	Burger	A burger emoji with patty and vegetables	Hamburger, cheeseburger
ğŸŸ	Fries	Brown french fries in a red carton	French fries, chips
ğŸ•	Pizza	A slice of pepperoni pizza	Slice of pizza, cheese pizza
ğŸŒ­	Hotdog	A popular western food featuring a sausage inside a bun	Sausage
ğŸŒ¯	Burrito	A wrapped dish filled with rice, beans, beef, and cheese	Wrap, roll
ğŸ§†	Falafel	A popular dish in the Middle East and North Africa	Flatbread, pita
ğŸ¥˜	A shallow pan of food	An emoji denoting a dish that contains rice, vegetables, and curry	Mix veg, pan
ğŸœ	Steaming bowl	A steaming bowl of rice or noodles	Ramen, noodles
ğŸ›	Curry and rice	Curry with rice	Curry, Indian food
ğŸ—	Poultry leg	This brown-colored emoji depicts a crispy chicken leg	Chicken, chicken leg piece, drumstick
ğŸ™	Rice ball	The emoji indicates a rice ball wrapped in seaweed	Onigiri, seaweed
ğŸ¥	Fish cake	A Japanese delicacy of processed whitefish served with ramen	Fish cake with swirl, pink swirl
ğŸ¥®	Mooncake	A traditional sweet Chinese delicacy	Chinese mooncake
ğŸ¡	Dango	A Japanese sweet dumpling made from rice flour and served on a skewer	Dessert stick 
ğŸ¥Ÿ	Dumpling	A popular Asian food filled with veg and non-veg items	Momos, Empanada
ğŸ§	Shaved ice	A shaved ice cone with cherry/strawberry syrup	Snowcone, ice-cream
ğŸ©	Doughnut	A chocolate doughnut emoji 	Donut
ğŸ°	Cake	A piece of cake or more specifically an emoji of a pastry	Pastry, shortcake, strawberry cake
ğŸ§	Cupcake	A cupcake emoji with pink cream topping	Muffin, fairy cake
â˜•	Hot beverage	This emoji can be related to coffee, tea, and other hot beverages	Tea, Espresso, hot chocolate
ğŸ«	Chocolate	A bar of chocolate in a red wrapper	Chocolate bar, candy bar
ğŸµ	Teacup without handle	A beverage cup without a handle and generally associated with green tea	Green tea, Matcha
ğŸ¥ƒ	Tumbler glass	A short and wide glass is used for liquors such as whiskey	Liquor, rum, whiskey
ğŸ§Š	Ice	An ice cube which is used to make drinks cooler	Ice cube
ğŸ¥„	Spoon	A simple silver spoon emoji	Teaspoon
ğŸ½ï¸	Fork & knife with plate	A cutlery emoji can be associated with having a meal	Dinner, cutlery
ğŸº	Beer	A mug filled with beer with frothy heads	Beer mug, beer stein
ğŸ»	Beers	The clinking of two beers mugs for the gesture of â€˜Cheers!â€™	Clinking beer mugs
ğŸŒ	Earth Africa	A globe of Earth showing the continent of Africa
ğŸŒ	Earth Americas	A globe of Earth showing the continent of North and South America
ğŸŒ	Earth Asia	A globe of Earth showing the continent of Asia
ğŸŒ	Globe with meridians	This emoji is generally associated with the internet
ğŸ—ºï¸	World map	A map showing the Earthâ€™s different continents
ğŸ—¾	Japan	An emoji depicting the geographical map of Japan
ğŸ§­	Compass	An instrument that shows the direction of the north
â›°ï¸	Mountain	This emoji depicts a mountain with sharp peaks at the top
ğŸ”ï¸	Snow-capped mountain	This emoji depicts a mountain with sharp snowy peaks at the top
ğŸ•ï¸	Camping	A tent placed within the forest for accommodation
ğŸŒ‹	Volcano	This emoji indicates the eruption of a volcano with lava and smoke
ğŸ—»	Mount Fuji	Mount Fuji is the largest mountain in Japan
ğŸï¸	Desert island	A desert but on an island
ğŸ–ï¸	Beach with umbrella	A beach emoji showing water, sand and umbrella for protection against the sun rays
ğŸœï¸	Desert	A land filled with sands, cacti and a scorching sun overhead
ğŸŸï¸	Stadium	A place where mega sports events take place such as football and cricket matches
ğŸï¸	National park	A park that comprises river streams, mountains and greenery
ğŸ›ï¸	Classical building	A classical building is the one that is associated with a town hall or a stock exchange
ğŸ§±	Bricks	An emoji of bricks that are used in building homes, schools and tons of other structures for an individual or the public
ğŸ—ï¸	Building construction	A construction site generally depicted as a tower crane shown lifting steel or other building materials
ğŸ 	House building	A simple house emoji with a red door
ğŸšï¸	Derelict house	An emoji which indicates unused house generally associated with haunted house
ğŸ¡	House with tree	A simple house emoji with a big tree behind it
ğŸ¢	Office	A place to work during business hours
ğŸ¤	Post office	Indicating a post building that involves sending and receiving parcels and packages from someone
ğŸ¥	Hospital	A place where people come to get medical care
ğŸ¦	Bank	A bank emoji indicates all the tasks related to money such as withdrawals, deposits, opening an account among others
ğŸ¨	Hotel	An accommodation place to stay when youâ€™re on a trip to another city or country
ğŸ©	Love hotel	An accommodation place for couples
ğŸ¬	Departmental store	An emoji indicating departmental store which caters to shopping for all kinds of different stuff
ğŸ«	School	An emoji depicting a school building where children go to get their education
ğŸ­	Factory	An industrial factory which can also be associated with air pollution
ğŸ¯	Japanese castle	This emoji means a traditional Japanese castle made from stone and wood
ğŸ—¼	Tower	A red tower generally associated with Tokyo tower and sometimes Eiffel tower
ğŸ—½	Statue of Liberty	This emoji is often used to depict New York City
â›ª	Church	A church building where people come to pray and at times to attend weddings and funerals
â›²	Fountain	Used for decorative purposes, a fountain is found in parks and gardens
â›º	Tent	A temporary shelter made out of cloth and related materials
ğŸŒ	Foggy	This emoji depicts a foggy landscape
ğŸŒƒ	Night with stars	Buildings with visible night stars in the sky
ğŸŒ„	Sunrise over mountains	The sun rising over a mountain range in the morning  
â™¨ï¸	Hotsprings	This emoji is a sign which indicates Hotsprings
ğŸ 	Carousel Horse	A kids horse ride found in carnivals and adventure parks
ğŸ¡	Ferris wheel	A large rotating wheel with cabinets for people to sit and witness the cityscape from great heights
ğŸ’ˆ	Barber	A red-white striped pole depicting a barbershop
ğŸª	Circus	A circus tent where several stunts are performed by professionals
ğŸšƒ	Railway car	A car carriage pulled along a railway line in cities
ğŸš…	Bullet train	A fast-paced train running on electricity generally used in rural areas or cities
ğŸš	Mountain railway	A passenger transport system used in hilly areas
ğŸšŒ	Bus	A public transport service which allows passengers to travel to their desired destinations
ğŸï¸	Motorcycle	A motorbike used in racing or motorsports
ğŸš—	Car	A red car emoji depicting an automobile
ğŸ›µ	Motor scooter	A light-weighted two-wheeler vehicle
ğŸ›º	Auto Rickshaw	A three-wheeled vehicle used in several Asian countries to transport a passenger from one place to another
ğŸ›¹	Skateboard	A classic emoji of a skateboard
ğŸ”¥	Fire	The fire emoji depicts hot, warm, flame and also used in context to represent coolness (lit)
ğŸ’§	Droplet	Used for various types of liquid such as water, tears, sweat and may even depict crying or sadness in some context
ğŸ•›	Twelve Oâ€™Clock	Emoji depicting 12 oâ€™clock either in the afternoon or midnight
â°	Alarm	Emoji depicting an alarm clock with a time of around 10:40 
ğŸŒ‘	New moon	A fully dark new moon
ğŸŒš	New moon face	Throwing ironic sentiments
ğŸŒ	Full moon face	Used in situations of sarcasm
ğŸª	Ringed planet	This emoji is made in a way to look like the Saturn planet
â­	Star	A simple and concise star emoji
ğŸŒ§ï¸	Cloud with rain	Can use this emoji when your plans are ruined by rain
ğŸŒ¤ï¸	Mostly sunny	An emoji used to represent a sunny and wonderful weather
ğŸŒªï¸	Tornado	An emoji that depicts a tornado
ğŸŒ«ï¸	Fog	An emoji depicting foggy weather
â˜”	Umbrella with raindrops	An umbrella with drops of water used for rainy weather
ğŸƒ	Jack-O-Lantern	The jack-o-lantern is the classic symbol of Halloween
ğŸ„	Christmas	The Christmas tree emoji represents Christmas and/or holidays
ğŸ†	Fireworks	Fireworks emoji represents the stunning combination of lights in the nighttime when burnt crackers
ğŸ§¨	Firecracker	A firecracker is burnt on various occasions across the globe such as Diwali, New Year celebrations etc.
âœ¨	Sparkles	Used to represent positive sentiments like happiness, gratitude and excitement
ğŸˆ	Balloon	The red balloon emoji represents birthday celebrations or a generic simple balloon 
ğŸ‰	Party popper	The party popper emoji is used to depict celebrations or parties
ğŸŠ	Confetti	Confetti emoji is used to depict celebrations or parties
ğŸ‹	Tanabata tree	A tree emoji specifically representing the Tanabata tree
ğŸ	Bamboo	A bamboo emoji representing the bamboo plant in a pot or cup
ğŸ	Dolls	Dolls indicating toys
ğŸ	Windchime	Used for content concerning various senses of wind and chime due to its appearance
ğŸ§§	Red envelope	Generally used in Asian cultures
ğŸ€	Ribbon	The emoji indicates something or someone is cute
ğŸ	Gift	An emoji indicating surprise, gift or presents
ğŸ—ï¸	Reminder ribbon	An awareness ribbon emoji
ğŸ«	Ticket	The ticket emoji is used when going to a place that requires a paid entry such as cinema, sports etc.
ğŸ–ï¸	Medal	The medal emoji represents an achievement recognition
ğŸ†	Trophy	The trophy emoji represents an achievement recognition
ğŸ¥‡	First place medal	A golden emoji used in chats to convey first place ranking in a sports or an event
âš½	Soccer	A soccer ball emoji depicting the football or soccer sport
âš¾	Baseball	A ball emoji but more specifically a baseball 
ğŸ€	Basketball	A basketball emoji showing the orange striped ball used in basketball
ğŸ	Volleyball	A volleyball emoji, showing the round ball used in the sport
ğŸ‰	Rugby football	This emoji depicts a famous western sport called rugby 
ğŸ¾	Tennis	A racket and ball emoji indicating the tennis sports
ğŸ“	Ping Pong	A paddle and ping pong ball used in the sport of table tennis.
ğŸ¥	Flying disc	A disc-like emoji depicting frisbee
ğŸ	Cricket game	A bat and ball emoji depicting the game of cricket
ğŸ³	Bowling	A ball and pin emoji depicting the indoor game called bowling
ğŸ‘	Field hockey	A hockey stick and ball, used in the sport of field hockey
ğŸ¥	Lacrosse	A sport in which two players have to hit the wall with a tennis ball using racquets
ğŸ¸	Badminton	A racquet and shuttlecock emoji representing badminton 
ğŸ¥Š	Boxing glove	A red boxing glove emoji depicting the boxing sport
ğŸ¥‹	Martial Arts	A traditional martial arts uniform emoji which depicts games such as judo or karate
ğŸ¥…	Goal net	Also known as goal pole, this emoji depicts a classic outdoor sport called soccer
â›³	Golf	Also known as a flag in the hole, this emoji depicts a red flag in a hole representing a sport called golf
â›¸ï¸	Ice skates	Ice skates are used to skate on a floor made of ice
ğŸ£	Fishing	This emoji represents a fishing rod and a fish hooked on to it
ğŸ¤¿	Diving mask	This emoji represents snorkels which is a crucial equipment used in diving or staying under the water for long durations
ğŸ¿	Ski	An outdoor winter sport in which a person slides down a snowy mountain or hill 
ğŸ¯	Darts	A dart emoji specifically depicting bullseye
ğŸª€	Yo-Yo	This is a fun little spinning gadget used during free time
ğŸª	Kite	A diamond-shaped red kite with a long tail
ğŸ±	8 Ball	The classic 8 ball representing games such as snooker and billiards
ğŸ”®	Crystal ball	Crystal ball emoji can be used in texts concerning magic and future prediction
ğŸ§¿	Nazar Amulet	This interesting looking emoji represents eyes and various senses of charm, envy & jealousy in Turkish culture
ğŸ•¹ï¸	Joystick	An emoji generally used to convey  playing video games but more specifically for classic or aviation genre games 
ğŸ®	Video game	This emoji can be used to call up your friends for a video game session
ğŸ°	Slot machine	One can use this emoji on a chat to make casino or gambling plans
ğŸ²	Dice	A six-sided die emoji that depicts dice used in board games such as ludo, monopoly etc.
ğŸ§¸	Teddy bear	Teddy bear emoji can be used to convey something or someone cute
â™ ï¸	Spades	A type of card used in playing cards
â™¥ï¸	Hearts	A type of card shaped like heart used in playing cards
â™¦ï¸	Diamonds	A type of card shaped like diamond used in playing cards
â™£ï¸	Clubs	A type of card used in playing cards
â™Ÿï¸	Chess	A chess piece called pawn
ğŸƒ	Joker	A card emoji that depicts joker
ğŸ€„	Mahjong	A red-white tile from the Japanese game called Mahjong
ğŸ­	Performing Arts	This emoji is used to indicate theatre or drama
ğŸ§¶	Yarn	A ball of yarn through which woolen clothes are sewed
ğŸ¨	Art	The emoji depicts color palette
